{StringUtils=com.succez.commons.util.StringUtils@7aef735d
dsmgr=dsmgr
test=test
tr=tr
td=td
br=br
newid=newid
systemsettingstree=systemsettingstree
explorer=explorer
ppteditoritem=ppteditoritem
capture_output=freemarker.template.utility.CaptureOutput@7e7f1db8
getchecker=getchecker
search=search
etldsn=etldsn
scheduleresselector=scheduleresselector
request=request
ctx=ctx
tobool=tobool
login=login
_message=_message
sz=sz
sqleditor=sqleditor
useragent=useragent
asset=asset
restoreConfirm=restoreConfirm
label=label
table=table
script=script
url=url
compress=freemarker.template.utility.StandardCompress@4b785be9
restore=restore
exportHtmlLayout=exportHtmlLayout
StringEscapeUtils=com.succez.commons.util.StringEscapeUtils@4ada44b4
rt=rt
span=span
WebUtils=com.succez.commons.util.WebUtils@3fd4abd0
stringify=stringify
dw=dw
attrData=attrData
html_escape=freemarker.template.utility.HtmlEscape@235c056d
div=div
widsn=widsn
normalize_newlines=freemarker.template.utility.NormalizeNewlines@6e68493d
projectform=projectform
reporttest=reporttest
personal=personal
DateFormatUtils=com.succez.commons.util.time.DateFormatUtils@a07c6c
style=style
messageExist=messageExist
if=if
setup=setup
ajaxframe=ajaxframe
slot=slot
xml_escape=freemarker.template.utility.XmlEscape@284896c6
formatDisplayText=formatDisplayText
dashboard2=dashboard2
backup=backup
suburl=suburl
dimbuilder=dimbuilder
prstexport=prstexport
jsdebug=jsdebug
error=error
dwaggregation=dwaggregation
indexmgr=indexmgr
joinAttrs=joinAttrs
factbuilder=factbuilder
message=message
settingslayout=settingslayout
FilenameUtils=com.succez.commons.util.FilenameUtils@35a2b5d3
schedule=schedule
pin=pin}